{
  "width": 16,
  "height": 16,
  "tile_width": 16,
  "tile_height": 16,

  "tiles": [
    [21,21,21,21,21,21,21,21,21,21,21,21,21,21,21,21],
    [23,20,20,20,20,20,20,20,20,20,20,20,20,20,20,24],
    [23,20,20,20,20,20,20,20,20,20,20,20,20,20,20,24],
    [23,20,20,20,20,20,20,20,20,20,20,20,20,20,20,24],
    [23,20,20,20,20,20,20,20,20,20,20,20,20,20,20,24],

    [0,0,0,0,0,0,0,0,0,0,0,0,0,0,0,0],
    [0,4,4,4,4,4,4,4,4,4,4,4,4,4,4,0],
    [0,5,5,5,5,5,5,5,5,5,5,5,5,5,5,0],
    [0,4,4,4,4,4,4,4,4,4,4,4,4,4,4,0],
    [0,0,0,0,0,0,0,0,0,0,0,0,0,0,0,0],

    [33,33,33,33,33,0,0,0,0,0,0,0,0,0,0,0],
    [34,34,34,35,34,0,0,0,0,0,0,0,0,0,0,0],
    [34,34,34,34,34,0,0,0,0,0,0,0,0,0,0,0],

    [0,0,0,0,0,0,0,0,0,0,0,0,0,0,0,0],
    [0,0,0,0,0,0,0,0,0,0,0,0,0,0,0,0],
    [0,0,0,0,0,0,0,0,0,0,0,0,0,0,0,0]
  ]
}
